1111111111111111
100000000000000111111111111111111111111111111111111
11E0020001001111                       1          1
 100000111101                          1          1
11000010000011111111                   111111111111
1000000000001      1
11111111111111111111
1111111      1
1111111      1
1111111      111111
             111111
