1111111111111111111
1000000000010000001
1110010000000000001
1000010001110000001
1000000000000100001
1000000000000000001
1000000000000000001
1000000000000000001
1000000N00000000001
1111111111111111111
