        1                       1
        1                       1
        1                       1
        1                       1
        1                       1
        1                       1
        1                       1
        1                       1
   1111111111111111111111111111111111111111111
1       1000000000110000000000001
1       1011000001110000002000001
1       1001000000000000000000001
111111111011000001110000000000001
10000000001100000111011111111111111111111111111
11110111111111011100000010001
11110111111111011101010010001
11000000110101011100000010001
110020000000000011000000100011
 10000000000000001101010010001
11000001110101011111011110N0111
11110111 1110101 101111010001
11111111 1111111 111111111111111111111111
                 1          1
                 1          1
                 1          1
