

C  255,0,0




     F   115,115,115


S      textures/texture.xpm
SO       textures/mur-1.xpm
NO textures/texture.xpm
EA textures/texture.xpm
WE textures/texture.xpm


               R                                      1920,1080


11111111111111
10000000000001
11E00000101011
 100000111101
1100001000001
1000000000001
11111111111111111111
            1
            1
            1
            1

           






















