1111111111111
10000000000001
1000020001001
1000001111E01
1000001000001
1000000000001
1111111111111
