1111111111111
1000000000001
1000020001001
10E0001111001
1000001000001
1000000000001
1111111111111
