1111111111111
1000000000101
10E0000111101
1000000100001
1000000000001
1111111111111
