1111111111111
1000001000001
10E0001000001
1000000000001
1000000000001
1111111111111
