11111111111111
10000000000001
11E00200010011
 100000111101
11000010000011
1000000000001
1111111111111
