1111111111111111
1000000000000001
11E0020001001111
 100000111101
11000010000011111111
1000000000001      1
11111111111111111111
1111111      1
1111111      1
1111111      111111
