1111111111111
1000000000001
10000000000W1
1000020000101
1000001111101
1000001000001
1000000000001
1111111111111
