1111111111111
1000010000001
10E0000000001
1000000100001
1000000100001
1111111111111
