1111111111111
1000111100001
10N0100010001
1000000000101
1000000111101
1111111111111
