1111111111111111111
1000000000010000001
1110010000010000001
1000010E01110100001
1000000000000000001
1000000000000100001
1000000000000000001
1000020000000000001
1000000000000000001
1111111111111111111
