11111111111111
10000000000001
11E00200010011
 100000111101
1100001000001
1000000000001
11111111111101
            1
