

C 255,255,255



F   255,115,115


S      textures/test-sprite.xpm
SO       textures/mur-1.xpm
NO textures/mur-3.xpm
EA textures/mur-2.xpm
WE textures/mur-4.xpm

R 85220 71551480

    11111111111111111     1
    1000000000000000111111111
 1  10000   0000W00000000000111111111
 11 10000   00000000111111101       1
  1110000 1 000010021     101       1
    10000   201011111     111   1   1
    1000001111111     
  1110001000001             1
  1000000000001
  111111111111111111111111111111111111   
              1      1
              1      1
              1      1
              1
                       
           






















