1111111111111
1000000000001
1000000000001
1000020000101
10000N1111101
1000001000001
1000000000001
1111111111111
