1111111111111111111
1000000000010000001
1110000000N00000001
1000010000000000001
1000000000000000001
1111111111111111111
