1111111111111
1000000000001
10E0000000011
1000000000001
1000000000001
1111111111111
