111111
110001
110001
101001
111111
