R 1111111111111111111
1000000000010000001
1110010000010000001
1000010E21110100001
1000000000002200001
1000002000020120001
1000000000000200001
1000000000002000001
1000000000000000001
1111111111111111111
