1111111111111
10000000S0001
1000000000001
1000000000101
1000001111101
1000001000001
1000000000001
1111111111111
