

C 2,255,255


F   2,100,0


S       textures/mur-1.xpm
SO      textures/test-sprite.xpm
NO textures/mur-2.xpm
EA textures/mur-4.xpm

WE textures/mur-3.xpm
R -1 -1

      11111111111111111     1
     1100000000000000011111111
  1  100000000000000020002000111111111
 111 100000000W000000111111101       1
 1 1110000010000010021     101       1
     10000000201111111     111       1
     10000011111     
   1110001000001              
   1000000000001
   1111111111111111
                       
           




 

















