11111111111111
10000200000001
11E00200010211
 100000111101
1100001000001
1000000000001
11111111111111111111
            1
            1
            1
            1
