1111111111111
1000000000001
1000000000001
1000000000101
10000E1111101
1000001000001
1000000000001
1111111111111
