

C 255,255,255


F   255,115,115


S      textures/test-sprite.xpm
SO       textures/mur-1.xpm
NO textures/mur-3.xpm
EA textures/mur-2.xpm
WE textures/mur-4.xpm

R -1865           -715

    11111111111111111     1
   1100000000000000011111111
1  10000   000E000000000000111111111
11 10000   00000000111111101       1
 1100000 1 000010021     101       1
   10000   201111111     111       1
   10000011111     
 1110001000001              
 1000000000001
 1111111111111111
                       
           




 

















